R 1920 1080
NO ./path_to_the_north_texture
SO ./path_to_the_south_texture
WE ./path_to_the_west_texture
EA ./path_to_the_east_texture

S ./path_to_the_sprite_texture
F 220,100,0
C 225,30,0

111111111111111 111111111
1000000000110011100000001
1011000001110000002000011
100100000000000000000001 
1111111110110000011100011
100000000011000001110110111111111
11110111111111011100000010001
 1110111111111011101010010001
11000000110101011100000010001
10002000000000001100000010001
100000000000N0001101010100001
11000001110101011111011100111
1111011111101011101111010001
11111110 1111111 11111111111