R 1920 1080
NO ./textures/lava.xpm
SO ./textures/lava.xpm
WE ./textures/redbrick.xpm
EA ./textures/wood.xpm

S ./textures/chest.xpm
F 220,100,0
C 102         ,      255 ,       255

     11111111111111111
     10000000000000001
     10002111111100001
11111110001 1010111111
1101E000001110001
10000010000000001
11111111111111111