R 1000 950

NO ./textures/brique2.xpm
SO  ./textures/brique2.xpm
WE ./textures/brique.xpm
EA ./textures/brique.xpm

C 102        ,   178 ,   255
F 2	     	,	     	 	    128 	    		 	,	  	 12



S    			./textures/barrel.xpm
S5   ./textures/shroom.xpm
S6 ./textures/health.xpm
SF ./textures/chopper.xpm
SB ./textures/skybox.xpm

        11111111111111111111111111111111111
        10000000061100000000000010050001111
        10110000011100000020000010111105111
        15610050000000000005000000116000061
1111111110110000011150000000000011110110111
1005000500110000011101111111111111115110011
1111011111111101110000001050111111100111011
1111511111111101110101551000111111131111111
110000001101010111000000100011111110041
100020005000000011000000105011111111111
10000500005000001101010000001
11000001110101011111011110N01
11110111 1110101 101111010061
11111111 1111111 111111111111