R    1920         1080
NO ./textures/wood.xpm
SO ./textures/eagle.xpm
WE ./textures/redbrick.xpm
EA ./textures/colorstone.xpm


S ./textures/barrel.xpm
F 220,100,0
C 102        ,   255 ,      255

11111   1111111111111111111111111
10001   1000000000110000000000021
10001   1011000E01110000000020001
10001   1001000000000000000000001
111111111011000001110000000000001
100000000000000001110111111111111
11110111111111011100000010001
11110111111111011101010010001
11000000110101011100000010001
10000000000000001100000000001
10000000000000001101010010001
1100000111010101111101111000111
11110111 1110101 101111010001
11111111 1111111 111111111111