R        1920     1080

SO ./textures/eagle.xpm
S 			./textures/barrel.xpm
F           2	     	,	     	 	    128 	    		 	,	  	 12



NO 	         ./textures/wood.xpm         



C          102        ,   178 ,   255

WE ./textures/redbrick.xpm
EA ./textures/colorstone.xpm





            11111   1111111111111111111111111
            10001   1000000000110000000000001
            10001   101100000003002000N010001
            10001   1001000000010000000000001
            111111111011000000010000000000001
            100000000000000011111111111111111
11111111111110000100000010001                  
10000000000000010101001000111               
11000000110101010100000010001                 
10000010000111000300000000001
10000000000100000101010010001
1100000111011101111101111000111
11110111 1112101 101111010001
11111111 1111111 111111111111