R    1920         1080
NO 	./textures/wood.xpm
SO ./textures/eagle.xpm
WE ./textures/redbrick.xpm
EA ./textures/colorstone.xpm


S ./textures/barrel.xpm
F 128	 	,	 	 	    128 	 		 	,	 	 	128
C 102        ,   178 ,   255

11111   1111111111111111111111111
10001   1000000000110000000000001
10001   1011000E01110000001111001
10001   10010000000000000001 1001
111111111011000001110000000111001
100000000000000001110111111111111
11110111111111011100000010001
11110111111111011101010010001
11000000110101011100000010001
10000000000000001100000000001
10000000000000001101010010001
1100000111010101111101111000111
11110111 1110101 101111010001
11111111 1111111 111111111111