R 1300 500

SO  we./textures/eagle.xpm
S 			./textures/barrel.xpm
F           2	     	,	     	 	    128 	    		 	,	  	 12


NO 	         ./textures/wood.xpm


C          102        ,   178 ,   255

WE ./textures/redbrick.xpm
EA ./textures/colorstone.xpm


            11111   1111111111111111111111111
            10001   1000000000110000000000001
            10001   101100000000002000N010001
            10001   1001000000010000000000001
            110111111011000000010000000000001
            100000000000000011111111111111111
111111111111100001000000100011111110001111111                
10000000000000010101111000111               
110000001101010101001 1010001             
10000010000111000300111000001
10000000000100000101010010001
11000001110111011111011110001
11110111 1112101 101111000001
11111111 1111111 111111111111