R 1920 1080
NO ./textures/lava.xpm
SO ./textures/eagle.xpm
WE ./textures/redbrick.xpm
EA ./textures/lava2.xpm

S ./textures/barrel.xpm
F 220,100,0, 123
C 102         ,      255 ,       255



        1111111111111111111111111111  
        100000000011000000000000011
        101100000111000000200000101111
        1001000000000000000000001101
111111111011000001110000000000001111
100000000011000001110111111111111
11110111111111011100000010001
11110111111111011101010010001
11000000110101011100000010001
10002000000000001100000010001
10000000000000000010100000011
11000001110101011111011110N0111
11110111 1110101 101111010001
11111111 1111111 111111111111