R 1920 1080
NO ./textures/lava.xpm
SO ./textures/eagle.xpm
WE ./textures/redbrick.xpm
EA ./textures/lava2.xpm

S ./textures/barrel.xpm
F 220,100,0
C 102         ,      255 ,       255

     1111111111111111111111111111111
     1000000000000000000000000000021
     1000000000000000000000000000021
     10E0000000110022111111111111111
1111111000101011111111
11010000001110001
10000010000022201
11111111111111111