R 1400 1050

C          102        ,   178 ,   255
F           2	     	,	     	 	    128 	    		 	,	  	 12

NO 	./textures/wall.xpm
SO  ./textures/brique2.xpm
WE ./textures/wall.xpm
EA ./textures/brique2.xpm

S 			./textures/barrel.xpm
S4      ./textures/chopper.xpm
S5      ./textures/shroom.xpm
S6      ./textures/health.xpm
SB ./textures/skybox.xpm

            11111   1111111111111111111111111
            10001   1000000000110000000000001
            10001   101100050000002000N010001
            10001   1001000000010040000000001
            110111111011000000610000000000001
            100000000500000011111111111111111
111111111111100001000000100011111110001111111
10005050500000000000000000001              
11000000000050000000000000001             
10000010000000000000006000001
10000000000000000000000000001
10000000000000000000000000001
10000000000000000000000000001
10000000000000000000000000001
10000000000000000000000000001
10000000000000000000000000001
10000060000020000000200200001
10000001110000011100000000001
10000001 1110101 101111000001
11111111 1111111 111111111111