R         1920            1080
NO ./textures/lava.xpm
SO ./textures/eagle.xpm
WE ./textures/redbrick.xpm
EA ./textures/lava2.xpm

S ./textures/barrel.xpm
F 220,100,0, 123
C 102         ,     255 ,       255



        111111111111111111111  
        100000000011000000001
        101100000111000000021
        100100000000000000021
11111111101100000111000000001
10000000001100000111011111111
11110111111111011100000010001
11110111111111011101010010001
11000000110101011100000010001
10002000000000001100000010001
10000000000000000010100000011
11000001110101011111011110N01
10000111 1110101 101111010001
11111111 1111111 111111111111