R    1920            1080
NO ./textures/lava.xpm
SO ./textures/eagle.xpm
WE ./textures/redbrick.xpm
EA ./textures/colorstone.xpm

S ./textures/barrel.xpm
F 220,100,0
C 102        ,     255 ,       255


1111111111
1000000001
10000N0001
1000000001
1111111111