111101
100111
102011
111111
111111