R    2000            1400
NO ./textures/lava.xpm
SO ./textures/eagle.xpm
WE ./textures/redbrick.xpm
EA ./textures/colorstone.xpm

S ./textures/barrel.xpm
F 220,100,0
C 102        ,    255 ,       255

1111111 11
0001111011
11201 1001
1000111001
10200000W1
1111111111