R 500 500
NO ./textures/lava.xpm
SO ./textures/lava.xpm
WE ./textures/redbrick.xpm
EA ./textures/wood.xpm

S ./textures/Chest2.xpm
F 220,100,0
C 102         ,      255 ,       255

     11111111111111111
     10000000000000001
     10000202020200001
     10000000001100001
1111111000101011111111
1101S000001110001
10000010000000001
11111111111111111