R 1000 1000

NO ./textures/wall.xpm
SO  ./textures/brique2.xpm
WE ./textures/brique.xpm
EA ./textures/mossy.xpm

C 102        ,   178 ,   255
F 2	     	,	     	 	    128 	    		 	,	  	 12



S    			./textures/barrel.xpm
S5   ./textures/shroom.xpm
S6 ./textures/health.xpm
SF ./textures/chopper.xpm
SB ./textures/skybox.xpm

        111111111
        1000S0001
        100000001
11111111100000001111111
10000000000000000000001
10000020005006000000001
10000000000000000001111
11111100111111111001
   14105111111111001
   10305111111111001
   10105111111111001
111111000000060000011111
100600000200000000020001
111111111111111111111111