R 1920 1080
NO ./textures/lava.xpm
SO ./textures/lava.xpm
WE ./textures/redbrick.xpm
EA ./textures/wood.xpm

S ./textures/chest.xpm
F 220,100,0
C 225,30,0

     11111111111111111
     10000000000000001
     10002002011100001
11111100001 1010111111
1000N001011100001
10000000000000001
11111111111111111